Index	X	Left to Right	X	Right to Left	X	Sum
0	1899/12/30	0	1899/12/30	0	1899/12/30	0
1	1899/12/30 0:00:10	0	1899/12/30 0:00:10	0	1899/12/30 0:00:10	0
2	1899/12/30 0:00:20	0	1899/12/30 0:00:20	0	1899/12/30 0:00:20	0
3	1899/12/30 0:00:30	0	1899/12/30 0:00:30	0	1899/12/30 0:00:30	0
4	1899/12/30 0:00:40	2	1899/12/30 0:00:40	0	1899/12/30 0:00:40	2
5	1899/12/30 0:00:50	3	1899/12/30 0:00:50	0	1899/12/30 0:00:50	3
6	1899/12/30 0:01:00	4	1899/12/30 0:01:00	0	1899/12/30 0:01:00	4
7	1899/12/30 0:01:10	1	1899/12/30 0:01:10	2	1899/12/30 0:01:10	3
8	1899/12/30 0:01:20	1	1899/12/30 0:01:20	2	1899/12/30 0:01:20	3
9	1899/12/30 0:01:30	2	1899/12/30 0:01:30	6	1899/12/30 0:01:30	8
10	1899/12/30 0:01:40	3	1899/12/30 0:01:40	5	1899/12/30 0:01:40	8
11	1899/12/30 0:01:50	2	1899/12/30 0:01:50	9	1899/12/30 0:01:50	11
12	1899/12/30 0:02:00	2	1899/12/30 0:02:00	8	1899/12/30 0:02:00	10
13	1899/12/30 0:02:10	2	1899/12/30 0:02:10	5	1899/12/30 0:02:10	7
14	1899/12/30 0:02:20	2	1899/12/30 0:02:20	8	1899/12/30 0:02:20	10
15	1899/12/30 0:02:30	2	1899/12/30 0:02:30	7	1899/12/30 0:02:30	9
16	1899/12/30 0:02:40	2	1899/12/30 0:02:40	4	1899/12/30 0:02:40	6
17	1899/12/30 0:02:50	2	1899/12/30 0:02:50	9	1899/12/30 0:02:50	11
18	1899/12/30 0:03:00	2	1899/12/30 0:03:00	11	1899/12/30 0:03:00	13
19	1899/12/30 0:03:10	1	1899/12/30 0:03:10	8	1899/12/30 0:03:10	9
20	1899/12/30 0:03:20	5	1899/12/30 0:03:20	3	1899/12/30 0:03:20	8
21	1899/12/30 0:03:30	1	1899/12/30 0:03:30	8	1899/12/30 0:03:30	9
22	1899/12/30 0:03:40	2	1899/12/30 0:03:40	6	1899/12/30 0:03:40	8
23	1899/12/30 0:03:50	2	1899/12/30 0:03:50	8	1899/12/30 0:03:50	10
24	1899/12/30 0:04:00	2	1899/12/30 0:04:00	5	1899/12/30 0:04:00	7
25	1899/12/30 0:04:10	2	1899/12/30 0:04:10	9	1899/12/30 0:04:10	11
26	1899/12/30 0:04:20	4	1899/12/30 0:04:20	4	1899/12/30 0:04:20	8
27	1899/12/30 0:04:30	2	1899/12/30 0:04:30	7	1899/12/30 0:04:30	9
28	1899/12/30 0:04:40	3	1899/12/30 0:04:40	9	1899/12/30 0:04:40	12
29	1899/12/30 0:04:50	5	1899/12/30 0:04:50	7	1899/12/30 0:04:50	12
30	1899/12/30 0:05:00	1	1899/12/30 0:05:00	6	1899/12/30 0:05:00	7
31	1899/12/30 0:05:10	1	1899/12/30 0:05:10	6	1899/12/30 0:05:10	7
32	1899/12/30 0:05:20	1	1899/12/30 0:05:20	11	1899/12/30 0:05:20	12
33	1899/12/30 0:05:30	2	1899/12/30 0:05:30	6	1899/12/30 0:05:30	8
34	1899/12/30 0:05:40	3	1899/12/30 0:05:40	4	1899/12/30 0:05:40	7
35	1899/12/30 0:05:50	16	1899/12/30 0:05:50	8	1899/12/30 0:05:50	24
36	1899/12/30 0:06:00	26	1899/12/30 0:06:00	9	1899/12/30 0:06:00	35
37	1899/12/30 0:06:10	18	1899/12/30 0:06:10	8	1899/12/30 0:06:10	26
38	1899/12/30 0:06:20	7	1899/12/30 0:06:20	10	1899/12/30 0:06:20	17
39	1899/12/30 0:06:30	19	1899/12/30 0:06:30	1	1899/12/30 0:06:30	20
40	1899/12/30 0:06:40	14	1899/12/30 0:06:40	2	1899/12/30 0:06:40	16
41	1899/12/30 0:06:50	6	1899/12/30 0:06:50	6	1899/12/30 0:06:50	12
42	1899/12/30 0:07:00	4	1899/12/30 0:07:00	4	1899/12/30 0:07:00	8
43	1899/12/30 0:07:10	12	1899/12/30 0:07:10	0	1899/12/30 0:07:10	12
44	1899/12/30 0:07:20	9	1899/12/30 0:07:20	0	1899/12/30 0:07:20	9
45	1899/12/30 0:07:30	10	1899/12/30 0:07:30	0	1899/12/30 0:07:30	10
46	1899/12/30 0:07:40	9	1899/12/30 0:07:40	0	1899/12/30 0:07:40	9
47	1899/12/30 0:07:50	5	1899/12/30 0:07:50	0	1899/12/30 0:07:50	5
48	1899/12/30 0:08:00	8	1899/12/30 0:08:00	0	1899/12/30 0:08:00	8
49	1899/12/30 0:08:10	1	1899/12/30 0:08:10	0	1899/12/30 0:08:10	1
50	1899/12/30 0:08:20	6	1899/12/30 0:08:20	0	1899/12/30 0:08:20	6
51	1899/12/30 0:08:30	3	1899/12/30 0:08:30	0	1899/12/30 0:08:30	3
52	1899/12/30 0:08:40	4	1899/12/30 0:08:40	2	1899/12/30 0:08:40	6
53	1899/12/30 0:08:50	5	1899/12/30 0:08:50	4	1899/12/30 0:08:50	9
54	1899/12/30 0:09:00	4	1899/12/30 0:09:00	3	1899/12/30 0:09:00	7
55	1899/12/30 0:09:10	0	1899/12/30 0:09:10	9	1899/12/30 0:09:10	9
56	1899/12/30 0:09:20	5	1899/12/30 0:09:20	11	1899/12/30 0:09:20	16
57	1899/12/30 0:09:30	2	1899/12/30 0:09:30	6	1899/12/30 0:09:30	8
58	1899/12/30 0:09:40	0	1899/12/30 0:09:40	5	1899/12/30 0:09:40	5
59	1899/12/30 0:09:50	2	1899/12/30 0:09:50	6	1899/12/30 0:09:50	8
60	1899/12/30 0:10:00	4	1899/12/30 0:10:00	6	1899/12/30 0:10:00	10
61	1899/12/30 0:10:10	3	1899/12/30 0:10:10	10	1899/12/30 0:10:10	13
62	1899/12/30 0:10:20	2	1899/12/30 0:10:20	9	1899/12/30 0:10:20	11
63	1899/12/30 0:10:30	2	1899/12/30 0:10:30	5	1899/12/30 0:10:30	7
64	1899/12/30 0:10:40	3	1899/12/30 0:10:40	10	1899/12/30 0:10:40	13
65	1899/12/30 0:10:50	1	1899/12/30 0:10:50	4	1899/12/30 0:10:50	5
66	1899/12/30 0:11:00	2	1899/12/30 0:11:00	7	1899/12/30 0:11:00	9
67	1899/12/30 0:11:10	6	1899/12/30 0:11:10	8	1899/12/30 0:11:10	14
68	1899/12/30 0:11:20	1	1899/12/30 0:11:20	15	1899/12/30 0:11:20	16
69	1899/12/30 0:11:30	3	1899/12/30 0:11:30	15	1899/12/30 0:11:30	18
70	1899/12/30 0:11:40	2	1899/12/30 0:11:40	14	1899/12/30 0:11:40	16
71	1899/12/30 0:11:50	4	1899/12/30 0:11:50	21	1899/12/30 0:11:50	25
72	1899/12/30 0:12:00	3	1899/12/30 0:12:00	11	1899/12/30 0:12:00	14
73	1899/12/30 0:12:10	2	1899/12/30 0:12:10	11	1899/12/30 0:12:10	13
74	1899/12/30 0:12:20	2	1899/12/30 0:12:20	13	1899/12/30 0:12:20	15
75	1899/12/30 0:12:30	2	1899/12/30 0:12:30	9	1899/12/30 0:12:30	11
76	1899/12/30 0:12:40	2	1899/12/30 0:12:40	23	1899/12/30 0:12:40	25
77	1899/12/30 0:12:50	1	1899/12/30 0:12:50	15	1899/12/30 0:12:50	16
78	1899/12/30 0:13:00	6	1899/12/30 0:13:00	16	1899/12/30 0:13:00	22
79	1899/12/30 0:13:10	3	1899/12/30 0:13:10	12	1899/12/30 0:13:10	15
80	1899/12/30 0:13:20	2	1899/12/30 0:13:20	13	1899/12/30 0:13:20	15
81	1899/12/30 0:13:30	4	1899/12/30 0:13:30	17	1899/12/30 0:13:30	21
82	1899/12/30 0:13:40	7	1899/12/30 0:13:40	6	1899/12/30 0:13:40	13
83	1899/12/30 0:13:50	1	1899/12/30 0:13:50	10	1899/12/30 0:13:50	11
84	1899/12/30 0:14:00	9	1899/12/30 0:14:00	11	1899/12/30 0:14:00	20
85	1899/12/30 0:14:10	1	1899/12/30 0:14:10	2	1899/12/30 0:14:10	3
86	1899/12/30 0:14:20	9	1899/12/30 0:14:20	4	1899/12/30 0:14:20	13
87	1899/12/30 0:14:30	5	1899/12/30 0:14:30	3	1899/12/30 0:14:30	8
88	1899/12/30 0:14:40	4	1899/12/30 0:14:40	9	1899/12/30 0:14:40	13
89	1899/12/30 0:14:50	3	1899/12/30 0:14:50	3	1899/12/30 0:14:50	6
90	1899/12/30 0:15:00	6	1899/12/30 0:15:00	1	1899/12/30 0:15:00	7
91	1899/12/30 0:15:10	5	1899/12/30 0:15:10	0	1899/12/30 0:15:10	5
92	1899/12/30 0:15:20	6	1899/12/30 0:15:20	3	1899/12/30 0:15:20	9
93	1899/12/30 0:15:30	4	1899/12/30 0:15:30	2	1899/12/30 0:15:30	6
94	1899/12/30 0:15:40	1	1899/12/30 0:15:40	5	1899/12/30 0:15:40	6
95	1899/12/30 0:15:50	1	1899/12/30 0:15:50	2	1899/12/30 0:15:50	3
96	1899/12/30 0:16:00	5	1899/12/30 0:16:00	4	1899/12/30 0:16:00	9
97	1899/12/30 0:16:10	2	1899/12/30 0:16:10	2	1899/12/30 0:16:10	4
98	1899/12/30 0:16:20	2	1899/12/30 0:16:20	1	1899/12/30 0:16:20	3
99	1899/12/30 0:16:30	5	1899/12/30 0:16:30	2	1899/12/30 0:16:30	7
100	1899/12/30 0:16:40	5	1899/12/30 0:16:40	0	1899/12/30 0:16:40	5
101	1899/12/30 0:16:50	2	1899/12/30 0:16:50	1	1899/12/30 0:16:50	3
102	1899/12/30 0:17:00	1	1899/12/30 0:17:00	0	1899/12/30 0:17:00	1
103	1899/12/30 0:17:10	3	1899/12/30 0:17:10	0	1899/12/30 0:17:10	3
104	1899/12/30 0:17:20	3	1899/12/30 0:17:20	0	1899/12/30 0:17:20	3
105	1899/12/30 0:17:30	2	1899/12/30 0:17:30	0	1899/12/30 0:17:30	2
106	1899/12/30 0:17:40	3	1899/12/30 0:17:40	0	1899/12/30 0:17:40	3
107	1899/12/30 0:17:50	15	1899/12/30 0:17:50	0	1899/12/30 0:17:50	15
108	1899/12/30 0:18:00	15	1899/12/30 0:18:00	0	1899/12/30 0:18:00	15
109	1899/12/30 0:18:10	29	1899/12/30 0:18:10	0	1899/12/30 0:18:10	29
110	1899/12/30 0:18:20	23	1899/12/30 0:18:20	0	1899/12/30 0:18:20	23
111	1899/12/30 0:18:30	12	1899/12/30 0:18:30	0	1899/12/30 0:18:30	12
112	1899/12/30 0:18:40	21	1899/12/30 0:18:40	0	1899/12/30 0:18:40	21
113	1899/12/30 0:18:50	25	1899/12/30 0:18:50	0	1899/12/30 0:18:50	25
114	1899/12/30 0:19:00	12	1899/12/30 0:19:00	0	1899/12/30 0:19:00	12
115	1899/12/30 0:19:10	17	1899/12/30 0:19:10	2	1899/12/30 0:19:10	19
116	1899/12/30 0:19:20	34	1899/12/30 0:19:20	5	1899/12/30 0:19:20	39
117	1899/12/30 0:19:30	15	1899/12/30 0:19:30	1	1899/12/30 0:19:30	16
118	1899/12/30 0:19:40	8	1899/12/30 0:19:40	9	1899/12/30 0:19:40	17
119	1899/12/30 0:19:50	6	1899/12/30 0:19:50	2	1899/12/30 0:19:50	8
120	1899/12/30 0:20:00	15	1899/12/30 0:20:00	7	1899/12/30 0:20:00	22
121	1899/12/30 0:20:10	6	1899/12/30 0:20:10	12	1899/12/30 0:20:10	18
122	1899/12/30 0:20:20	11	1899/12/30 0:20:20	16	1899/12/30 0:20:20	27
123	1899/12/30 0:20:30	15	1899/12/30 0:20:30	13	1899/12/30 0:20:30	28
124	1899/12/30 0:20:40	16	1899/12/30 0:20:40	16	1899/12/30 0:20:40	32
125	1899/12/30 0:20:50	5	1899/12/30 0:20:50	17	1899/12/30 0:20:50	22
126	1899/12/30 0:21:00	7	1899/12/30 0:21:00	20	1899/12/30 0:21:00	27
127	1899/12/30 0:21:10	1	1899/12/30 0:21:10	16	1899/12/30 0:21:10	17
128	1899/12/30 0:21:20	2	1899/12/30 0:21:20	13	1899/12/30 0:21:20	15
129	1899/12/30 0:21:30	2	1899/12/30 0:21:30	13	1899/12/30 0:21:30	15
130	1899/12/30 0:21:40	0	1899/12/30 0:21:40	14	1899/12/30 0:21:40	14
131	1899/12/30 0:21:50	5	1899/12/30 0:21:50	17	1899/12/30 0:21:50	22
132	1899/12/30 0:22:00	7	1899/12/30 0:22:00	13	1899/12/30 0:22:00	20
133	1899/12/30 0:22:10	6	1899/12/30 0:22:10	17	1899/12/30 0:22:10	23
134	1899/12/30 0:22:20	5	1899/12/30 0:22:20	21	1899/12/30 0:22:20	26
135	1899/12/30 0:22:30	3	1899/12/30 0:22:30	17	1899/12/30 0:22:30	20
136	1899/12/30 0:22:40	3	1899/12/30 0:22:40	14	1899/12/30 0:22:40	17
137	1899/12/30 0:22:50	3	1899/12/30 0:22:50	11	1899/12/30 0:22:50	14
138	1899/12/30 0:23:00	2	1899/12/30 0:23:00	5	1899/12/30 0:23:00	7
139	1899/12/30 0:23:10	4	1899/12/30 0:23:10	3	1899/12/30 0:23:10	7
140	1899/12/30 0:23:20	4	1899/12/30 0:23:20	2	1899/12/30 0:23:20	6
141	1899/12/30 0:23:30	4	1899/12/30 0:23:30	1	1899/12/30 0:23:30	5
142	1899/12/30 0:23:40	5	1899/12/30 0:23:40	2	1899/12/30 0:23:40	7
143	1899/12/30 0:23:50	7	1899/12/30 0:23:50	5	1899/12/30 0:23:50	12
144	1899/12/30 0:24:00	6	1899/12/30 0:24:00	1	1899/12/30 0:24:00	7
145	1899/12/30 0:24:10	4	1899/12/30 0:24:10	2	1899/12/30 0:24:10	6
146	1899/12/30 0:24:20	4	1899/12/30 0:24:20	1	1899/12/30 0:24:20	5
147	1899/12/30 0:24:30	6	1899/12/30 0:24:30	0	1899/12/30 0:24:30	6
148	1899/12/30 0:24:40	7	1899/12/30 0:24:40	1	1899/12/30 0:24:40	8
149	1899/12/30 0:24:50	1	1899/12/30 0:24:50	3	1899/12/30 0:24:50	4
150	1899/12/30 0:25:00	4	1899/12/30 0:25:00	3	1899/12/30 0:25:00	7
151	1899/12/30 0:25:10	5	1899/12/30 0:25:10	5	1899/12/30 0:25:10	10
152	1899/12/30 0:25:20	4	1899/12/30 0:25:20	5	1899/12/30 0:25:20	9
153	1899/12/30 0:25:30	4	1899/12/30 0:25:30	3	1899/12/30 0:25:30	7
154	1899/12/30 0:25:40	7	1899/12/30 0:25:40	1	1899/12/30 0:25:40	8
155	1899/12/30 0:25:50	4	1899/12/30 0:25:50	4	1899/12/30 0:25:50	8
156	1899/12/30 0:26:00	3	1899/12/30 0:26:00	1	1899/12/30 0:26:00	4
157	1899/12/30 0:26:10	5	1899/12/30 0:26:10	2	1899/12/30 0:26:10	7
158	1899/12/30 0:26:20	6	1899/12/30 0:26:20	1	1899/12/30 0:26:20	7
159	1899/12/30 0:26:30	3	1899/12/30 0:26:30	2	1899/12/30 0:26:30	5
160	1899/12/30 0:26:40	4	1899/12/30 0:26:40	2	1899/12/30 0:26:40	6
161	1899/12/30 0:26:50	4	1899/12/30 0:26:50	2	1899/12/30 0:26:50	6
162	1899/12/30 0:27:00	2	1899/12/30 0:27:00	3	1899/12/30 0:27:00	5
163	1899/12/30 0:27:10	2	1899/12/30 0:27:10	3	1899/12/30 0:27:10	5
164	1899/12/30 0:27:20	5	1899/12/30 0:27:20	6	1899/12/30 0:27:20	11
165	1899/12/30 0:27:30	5	1899/12/30 0:27:30	8	1899/12/30 0:27:30	13
166	1899/12/30 0:27:40	4	1899/12/30 0:27:40	6	1899/12/30 0:27:40	10
167	1899/12/30 0:27:50	0	1899/12/30 0:27:50	12	1899/12/30 0:27:50	12
168	1899/12/30 0:28:00	3	1899/12/30 0:28:00	13	1899/12/30 0:28:00	16
169	1899/12/30 0:28:10	3	1899/12/30 0:28:10	12	1899/12/30 0:28:10	15
170	1899/12/30 0:28:20	1	1899/12/30 0:28:20	9	1899/12/30 0:28:20	10
171	1899/12/30 0:28:30	2	1899/12/30 0:28:30	5	1899/12/30 0:28:30	7
172	1899/12/30 0:28:40	4	1899/12/30 0:28:40	8	1899/12/30 0:28:40	12
173	1899/12/30 0:28:50	1	1899/12/30 0:28:50	5	1899/12/30 0:28:50	6
174	1899/12/30 0:29:00	2	1899/12/30 0:29:00	5	1899/12/30 0:29:00	7
175	1899/12/30 0:29:10	2	1899/12/30 0:29:10	10	1899/12/30 0:29:10	12
176	1899/12/30 0:29:20	4	1899/12/30 0:29:20	7	1899/12/30 0:29:20	11
177	1899/12/30 0:29:30	4	1899/12/30 0:29:30	9	1899/12/30 0:29:30	13
178	1899/12/30 0:29:40	4	1899/12/30 0:29:40	8	1899/12/30 0:29:40	12
179	1899/12/30 0:29:50	4	1899/12/30 0:29:50	8	1899/12/30 0:29:50	12
180	1899/12/30 0:30:00	7	1899/12/30 0:30:00	13	1899/12/30 0:30:00	20
181	1899/12/30 0:30:10	10	1899/12/30 0:30:10	8	1899/12/30 0:30:10	18
182	1899/12/30 0:30:20	11	1899/12/30 0:30:20	11	1899/12/30 0:30:20	22
183	1899/12/30 0:30:30	25	1899/12/30 0:30:30	6	1899/12/30 0:30:30	31
184	1899/12/30 0:30:40	13	1899/12/30 0:30:40	8	1899/12/30 0:30:40	21
185	1899/12/30 0:30:50	14	1899/12/30 0:30:50	4	1899/12/30 0:30:50	18
186	1899/12/30 0:31:00	17	1899/12/30 0:31:00	4	1899/12/30 0:31:00	21
187	1899/12/30 0:31:10	16	1899/12/30 0:31:10	4	1899/12/30 0:31:10	20
188	1899/12/30 0:31:20	11	1899/12/30 0:31:20	8	1899/12/30 0:31:20	19
189	1899/12/30 0:31:30	11	1899/12/30 0:31:30	4	1899/12/30 0:31:30	15
190	1899/12/30 0:31:40	12	1899/12/30 0:31:40	6	1899/12/30 0:31:40	18
191	1899/12/30 0:31:50	17	1899/12/30 0:31:50	11	1899/12/30 0:31:50	28
192	1899/12/30 0:32:00	18	1899/12/30 0:32:00	6	1899/12/30 0:32:00	24
193	1899/12/30 0:32:10	19	1899/12/30 0:32:10	6	1899/12/30 0:32:10	25
194	1899/12/30 0:32:20	10	1899/12/30 0:32:20	10	1899/12/30 0:32:20	20
195	1899/12/30 0:32:30	15	1899/12/30 0:32:30	1	1899/12/30 0:32:30	16
196	1899/12/30 0:32:40	27	1899/12/30 0:32:40	2	1899/12/30 0:32:40	29
197	1899/12/30 0:32:50	19	1899/12/30 0:32:50	2	1899/12/30 0:32:50	21
198	1899/12/30 0:33:00	12	1899/12/30 0:33:00	3	1899/12/30 0:33:00	15
199	1899/12/30 0:33:10	18	1899/12/30 0:33:10	1	1899/12/30 0:33:10	19
200	1899/12/30 0:33:20	18	1899/12/30 0:33:20	2	1899/12/30 0:33:20	20
201	1899/12/30 0:33:30	24	1899/12/30 0:33:30	3	1899/12/30 0:33:30	27
202	1899/12/30 0:33:40	20	1899/12/30 0:33:40	3	1899/12/30 0:33:40	23
203	1899/12/30 0:33:50	12	1899/12/30 0:33:50	1	1899/12/30 0:33:50	13
204	1899/12/30 0:34:00	10	1899/12/30 0:34:00	3	1899/12/30 0:34:00	13
205	1899/12/30 0:34:10	12	1899/12/30 0:34:10	2	1899/12/30 0:34:10	14
206	1899/12/30 0:34:20	14	1899/12/30 0:34:20	4	1899/12/30 0:34:20	18
207	1899/12/30 0:34:30	9	1899/12/30 0:34:30	3	1899/12/30 0:34:30	12
208	1899/12/30 0:34:40	7	1899/12/30 0:34:40	4	1899/12/30 0:34:40	11
209	1899/12/30 0:34:50	11	1899/12/30 0:34:50	3	1899/12/30 0:34:50	14
210	1899/12/30 0:35:00	8	1899/12/30 0:35:00	5	1899/12/30 0:35:00	13
211	1899/12/30 0:35:10	5	1899/12/30 0:35:10	8	1899/12/30 0:35:10	13
212	1899/12/30 0:35:20	6	1899/12/30 0:35:20	8	1899/12/30 0:35:20	14
213	1899/12/30 0:35:30	1	1899/12/30 0:35:30	6	1899/12/30 0:35:30	7
214	1899/12/30 0:35:40	6	1899/12/30 0:35:40	10	1899/12/30 0:35:40	16
215	1899/12/30 0:35:50	4	1899/12/30 0:35:50	13	1899/12/30 0:35:50	17
216	1899/12/30 0:36:00	2	1899/12/30 0:36:00	16	1899/12/30 0:36:00	18
217	1899/12/30 0:36:10	2	1899/12/30 0:36:10	10	1899/12/30 0:36:10	12
218	1899/12/30 0:36:20	4	1899/12/30 0:36:20	14	1899/12/30 0:36:20	18
219	1899/12/30 0:36:30	5	1899/12/30 0:36:30	14	1899/12/30 0:36:30	19
220	1899/12/30 0:36:40	1	1899/12/30 0:36:40	10	1899/12/30 0:36:40	11
221	1899/12/30 0:36:50	3	1899/12/30 0:36:50	14	1899/12/30 0:36:50	17
222	1899/12/30 0:37:00	3	1899/12/30 0:37:00	7	1899/12/30 0:37:00	10
223	1899/12/30 0:37:10	2	1899/12/30 0:37:10	18	1899/12/30 0:37:10	20
224	1899/12/30 0:37:20	6	1899/12/30 0:37:20	21	1899/12/30 0:37:20	27
225	1899/12/30 0:37:30	5	1899/12/30 0:37:30	8	1899/12/30 0:37:30	13
226	1899/12/30 0:37:40	3	1899/12/30 0:37:40	9	1899/12/30 0:37:40	12
227	1899/12/30 0:37:50	1	1899/12/30 0:37:50	18	1899/12/30 0:37:50	19
228	1899/12/30 0:38:00	4	1899/12/30 0:38:00	15	1899/12/30 0:38:00	19
229	1899/12/30 0:38:10	5	1899/12/30 0:38:10	18	1899/12/30 0:38:10	23
230	1899/12/30 0:38:20	2	1899/12/30 0:38:20	11	1899/12/30 0:38:20	13
231	1899/12/30 0:38:30	1	1899/12/30 0:38:30	8	1899/12/30 0:38:30	9
232	1899/12/30 0:38:40	6	1899/12/30 0:38:40	6	1899/12/30 0:38:40	12
233	1899/12/30 0:38:50	5	1899/12/30 0:38:50	3	1899/12/30 0:38:50	8
234	1899/12/30 0:39:00	2	1899/12/30 0:39:00	7	1899/12/30 0:39:00	9
235	1899/12/30 0:39:10	2	1899/12/30 0:39:10	2	1899/12/30 0:39:10	4
236	1899/12/30 0:39:20	4	1899/12/30 0:39:20	7	1899/12/30 0:39:20	11
237	1899/12/30 0:39:30	8	1899/12/30 0:39:30	2	1899/12/30 0:39:30	10
238	1899/12/30 0:39:40	4	1899/12/30 0:39:40	5	1899/12/30 0:39:40	9
239	1899/12/30 0:39:50	4	1899/12/30 0:39:50	5	1899/12/30 0:39:50	9
240	1899/12/30 0:40:00	2	1899/12/30 0:40:00	3	1899/12/30 0:40:00	5
241	1899/12/30 0:40:10	7	1899/12/30 0:40:10	1	1899/12/30 0:40:10	8
242	1899/12/30 0:40:20	3	1899/12/30 0:40:20	3	1899/12/30 0:40:20	6
243	1899/12/30 0:40:30	1	1899/12/30 0:40:30	7	1899/12/30 0:40:30	8
244	1899/12/30 0:40:40	4	1899/12/30 0:40:40	4	1899/12/30 0:40:40	8
245	1899/12/30 0:40:50	6	1899/12/30 0:40:50	3	1899/12/30 0:40:50	9
246	1899/12/30 0:41:00	2	1899/12/30 0:41:00	4	1899/12/30 0:41:00	6
247	1899/12/30 0:41:10	5	1899/12/30 0:41:10	1	1899/12/30 0:41:10	6
248	1899/12/30 0:41:20	2	1899/12/30 0:41:20	3	1899/12/30 0:41:20	5
249	1899/12/30 0:41:30	3	1899/12/30 0:41:30	2	1899/12/30 0:41:30	5
250	1899/12/30 0:41:40	4	1899/12/30 0:41:40	2	1899/12/30 0:41:40	6
251	1899/12/30 0:41:50	8	1899/12/30 0:41:50	5	1899/12/30 0:41:50	13
252	1899/12/30 0:42:00	8	1899/12/30 0:42:00	6	1899/12/30 0:42:00	14
253	1899/12/30 0:42:10	15	1899/12/30 0:42:10	0	1899/12/30 0:42:10	15
254	1899/12/30 0:42:20	12	1899/12/30 0:42:20	0	1899/12/30 0:42:20	12
255	1899/12/30 0:42:30	7	1899/12/30 0:42:30	0	1899/12/30 0:42:30	7
256	1899/12/30 0:42:40	14	1899/12/30 0:42:40	0	1899/12/30 0:42:40	14
257	1899/12/30 0:42:50	16	1899/12/30 0:42:50	0	1899/12/30 0:42:50	16
258	1899/12/30 0:43:00	35	1899/12/30 0:43:00	1	1899/12/30 0:43:00	36
259	1899/12/30 0:43:10	19	1899/12/30 0:43:10	2	1899/12/30 0:43:10	21
260	1899/12/30 0:43:20	13	1899/12/30 0:43:20	0	1899/12/30 0:43:20	13
261	1899/12/30 0:43:30	31	1899/12/30 0:43:30	0	1899/12/30 0:43:30	31
262	1899/12/30 0:43:40	17	1899/12/30 0:43:40	1	1899/12/30 0:43:40	18
263	1899/12/30 0:43:50	24	1899/12/30 0:43:50	2	1899/12/30 0:43:50	26
264	1899/12/30 0:44:00	26	1899/12/30 0:44:00	1	1899/12/30 0:44:00	27
265	1899/12/30 0:44:10	24	1899/12/30 0:44:10	5	1899/12/30 0:44:10	29
266	1899/12/30 0:44:20	20	1899/12/30 0:44:20	2	1899/12/30 0:44:20	22
267	1899/12/30 0:44:30	31	1899/12/30 0:44:30	8	1899/12/30 0:44:30	39
268	1899/12/30 0:44:40	25	1899/12/30 0:44:40	7	1899/12/30 0:44:40	32
269	1899/12/30 0:44:50	12	1899/12/30 0:44:50	10	1899/12/30 0:44:50	22
270	1899/12/30 0:45:00	3	1899/12/30 0:45:00	11	1899/12/30 0:45:00	14
271	1899/12/30 0:45:10	3	1899/12/30 0:45:10	12	1899/12/30 0:45:10	15
272	1899/12/30 0:45:20	3	1899/12/30 0:45:20	22	1899/12/30 0:45:20	25
273	1899/12/30 0:45:30	1	1899/12/30 0:45:30	9	1899/12/30 0:45:30	10
274	1899/12/30 0:45:40	3	1899/12/30 0:45:40	17	1899/12/30 0:45:40	20
275	1899/12/30 0:45:50	2	1899/12/30 0:45:50	7	1899/12/30 0:45:50	9
276	1899/12/30 0:46:00	4	1899/12/30 0:46:00	11	1899/12/30 0:46:00	15
277	1899/12/30 0:46:10	2	1899/12/30 0:46:10	7	1899/12/30 0:46:10	9
278	1899/12/30 0:46:20	6	1899/12/30 0:46:20	7	1899/12/30 0:46:20	13
279	1899/12/30 0:46:30	3	1899/12/30 0:46:30	8	1899/12/30 0:46:30	11
280	1899/12/30 0:46:40	3	1899/12/30 0:46:40	17	1899/12/30 0:46:40	20
281	1899/12/30 0:46:50	4	1899/12/30 0:46:50	10	1899/12/30 0:46:50	14
282	1899/12/30 0:47:00	7	1899/12/30 0:47:00	14	1899/12/30 0:47:00	21
283	1899/12/30 0:47:10	2	1899/12/30 0:47:10	17	1899/12/30 0:47:10	19
284	1899/12/30 0:47:20	2	1899/12/30 0:47:20	11	1899/12/30 0:47:20	13
285	1899/12/30 0:47:30	7	1899/12/30 0:47:30	11	1899/12/30 0:47:30	18
286	1899/12/30 0:47:40	6	1899/12/30 0:47:40	7	1899/12/30 0:47:40	13
287	1899/12/30 0:47:50	6	1899/12/30 0:47:50	5	1899/12/30 0:47:50	11
288	1899/12/30 0:48:00	5	1899/12/30 0:48:00	6	1899/12/30 0:48:00	11
289	1899/12/30 0:48:10	6	1899/12/30 0:48:10	3	1899/12/30 0:48:10	9
290	1899/12/30 0:48:20	5	1899/12/30 0:48:20	3	1899/12/30 0:48:20	8
291	1899/12/30 0:48:30	3	1899/12/30 0:48:30	4	1899/12/30 0:48:30	7
292	1899/12/30 0:48:40	7	1899/12/30 0:48:40	3	1899/12/30 0:48:40	10
293	1899/12/30 0:48:50	7	1899/12/30 0:48:50	5	1899/12/30 0:48:50	12
294	1899/12/30 0:49:00	6	1899/12/30 0:49:00	1	1899/12/30 0:49:00	7
295	1899/12/30 0:49:10	3	1899/12/30 0:49:10	2	1899/12/30 0:49:10	5
296	1899/12/30 0:49:20	5	1899/12/30 0:49:20	6	1899/12/30 0:49:20	11
297	1899/12/30 0:49:30	7	1899/12/30 0:49:30	1	1899/12/30 0:49:30	8
298	1899/12/30 0:49:40	6	1899/12/30 0:49:40	3	1899/12/30 0:49:40	9
299	1899/12/30 0:49:50	4	1899/12/30 0:49:50	2	1899/12/30 0:49:50	6
300	1899/12/30 0:50:00	6	1899/12/30 0:50:00	1	1899/12/30 0:50:00	7
